XXXXXXXXXXXXBBXXXXXX
X000000000B.......XX
XBBBBBBBBBB  0O   .X
XX  O   O   OOO0  .X
B     O     0OOO  .X
B  OOOOOOO  .O0   .X
BSS   O    X.    B.X
XBB O   OB  .   BB.X
X0B      BD .  BB .X
X0B.....XB. . BB  .X
X0B    BBBB .B  O .X
X0BOOOOOOO  .B O O.X
X0BOOOOOOO  .B  O .X
X0B................X
XXXXXXXXXXXXXXXXXXXX
120
\L]\G^@W
TEDDYBAER
