XXXXXXXXXXXXXXXXXXXX
X.........SX.......X
X..........X...XXX.X
X..X.......X...X...X
X..X.XXXXX.X...X.D.X
X..X.... O X...X...X
XX.X...D   BOX.BXXXX
XOXXXXXXXXXXOXOXOOOX
X.OOOOOOOOOO.XOXOXOX
X..X X X X X.XOXOXOX
X...X.X.X.X..XOXOXOX
X.............OXOXOX
X..X.OXX......XXOXOX
X..X .XX.....BOOOXOB
XXXXBXXXXXXXXXXXXXXX
120
IL]V@TS@
LIKE THE PASSWORD SAYS, EASY PEASY
