XXXXXXXXXXXXXXXXXXXX
XBBDDB  O..........X
X0BX    O.O.....O..X
X0XXO   O....XXXO..X
X0XX  OXO.O........X
X0B.BO.OX..O..O....X
X0B..XOOOX..O...O..X
X0BO..XO.OX..O.....X
X0B.O..XO.OOO X...BX
XBB..O..X..O.XO..BBX
X.....O..O.BXB..BBBX
X......... XB..BBBBX
X......O......BBBBBX
X.S....O.....BBBBBBX
XXBBXXXXXXXXXXXXXXXX
130
JH\]QC[3
Tyloki
