XXXXXXXXXXXXXXXXXXXX
XDDDDDDDDDDDDDDDDDOX
BDDDDDDDDDDDDDDDDODX
XDDDDDDDDDDDDDDDODDX
XDDDDDDDDDD DDDODDDX
XDDDDDDDDDD DDODDDDX
XDDDDDDDDDD DODDDDDX
XDDDDDDDDDD ODDDDDDX
XDDDDDDDDDOOXXDDDDDX
XDDDDDDDDDOS XDDDDDX
XDDDDDDDOODDDDDDDDDX
XDDODDDOOXXXXXXDDDDX
XOOODOOODDDDDDDDDDDX
XBOBOOODDDDDDDDDDDDX
X0XXXXXXXXXXXXXXXXXX
10
NOLMRSPQ
MOUSE MAN 1
