DODDDDDD  DDDDDDODDD
DDODDDDDO DDDDDODDDD
DDDOOOODO DOOOODDDXX
ODDOBBBOO OBBBODDOXX
BODOBDDDOSDDDBODOBXX
DBOOOBBBOOBBBOOOBDXX
DDBOBOOOOOOOOBOBDDXX
DDBOBBOBBBBOBBOBDDXX
DBOOOBBOBBOBBOOOBDXX
BODOOOBBOOBBOODDOBXX
ODDDDOOOOOOOODDDDOXX
DDDDDDDOOOODDDDDDDXX
DDDDDDO0OO0ODDDDDDDD
DDDDDO00OO00ODDDDDDD
DDDDO0000O000ODDDDDD
10
NBCM0123
KAWUM
