XXXXXXXXXXXXXXXXXXXX
XD...X   XD   X...DX
XXOXBX X XX XOXBXOXX
X..O.X X XX X X.O. X
XD...X X XX X X...DX
XXX..X X XX X X..XXX
X. X.X X XX X X.X .X
X. ..X X XX X X.. .X
X. XOX X XX X XOX .X
XOOX.X X XX X X.XOOX
X O..X X XX X B..O X
X OSXX X XX XDXX.O X
XX.OOX X XX X XOO.XX
XX..OB X    XOXO..XX
XXXXXXXXXXXXXBXXXXXX
150
KH@JBPFV
MIRROR IMAGE
