XXXXXXXXXXXXXXXXXXXX
X  DX D X X    X   X
XO BB X XSO.XX X X X
X BOX B X X    X X X
XBOX  X X   X  X X X
XOX  XXOXXX.   X X X
XOX XXD  D.  X  BXBB
XOBOXXXXXXX.XXXXOXXO
XBOBXXXOXOXXOXXOXXOX
XBXBB O ..OBXOOXXOOX
OXXXO   XXXOBXXXOXDX
XOXOX O ..OBXOOO   X
XOXOX XOXOBXOXXX X X
XOXOXDBBBBBO       X
XXOXXXXXXXXXXXXXXXXX
120
DDF@XXZ\
THE MINE
