XXXXXXXXXXXXXXXXXXXX
XOXXXXXXXXXXXXXXXXXX
XO.OOOOOOOOOOOOOOOOO
XOXOXXXXXXXXXXXXXXXO
XOXOXOOOOOOOOOOOOOXO
XOXOXOXXXXXXXXXXXOXO
XOXOXOX.DOOOOOOOXOXO
XOXOXOX.XXXXXXXOXOXO
XOXOXOXOXXXS.DXOXOXO
XOXOXOXOO0....XOXOXO
XOXOXOXXXXXXXXXOXOXO
XOXOXOOOOOOOOOOOXOXO
XOXOXXXXXXXXXXXXXOXO
BOXOOOOOOOOOOOOOOOXO
XXXXXXXXXXXXXXXXXXXO
50
]XK\DX]]
BE SMART
