XXXXXXXXXXXXXXXXXBBX
XS X.     O .......X
X  X. OXO..O.......X
X  X...OX.. O.X    X
X  X...XO..X..OX XOX
X..XD..OX..X..XO OXX
X..OX..XO.....OX OOX
X..XO.   .....XOOXOX
X..OXXXXO X...OX OXX
X..XOD..  X...XO OOX
X..OX ..O X...OX XOX
X..XXXXXXXX...XO OXX
X.............OX OOX
X..................X
XXXXXXXXXXXXXXXXXXXX
120
_NFJYBAV
BE CAREFUL
