XXXXXXXXXXXXXXXXXXXX
XXOOXO....X.....XDDX
XXOOXO.X..X..X..X..X
XXOOXO.X..X..X.OX..X
XXOOXO.X..X..X..X..X
XXOOXO.X..X..X..X..X
XX..XO.X..X..X..X..X
XX..XO.X..X..X..X..X
XD..X..X..O..X..X..X
XD.OX..X..X..X..X..X
XX..X..X..X..X..X..X
XX..X..X..X..X..X..X
XX.OXO.X..X..X..X..X
XX.....X..X..X....SX
XXXXXXXXXXXXXXXXBBXX
83
OAAX^BFV
A.P. 3.
