XXXXXXXXXXXOOXXXXBXX
XX X....XX XXOX.O.DX
X SO.XX..X BBOX.D..X
XX X....XX BBOXXOXXX
X ... XB.BOBBOX....X
XX X X X. BBBOX.D.DX
X  XX OX..XBBOXX.XXO
X      DX.XBBOX.O..X
XX X  DB..XBBOX....X
XDXXXBXX..XBBOXXDXXX
X..XO.D...XBBOX....X
OXO.XOX...XBBOX....X
XOX..XX.O.XBBOXXOXXX
XBOX.D.....BBO D  OX
XXXOXXXXXXXXXXXXXXXX
120
AB\[QC23
THE WALL
