XXXXXXXXXXXXXXXXXXXX
X           OB X   X
X........    BOB   X
X.O...O..  XDXBX  XX
X........X X OBXXXDX
X...O...OX XDB.  O X
X........X   X.X  SX
XXOXOXOX.XXXXX.XXXXO
XX       X0OOOOOOOOX
XXXXXXXX.X.........X
XOOOOOO DX O...D...B
XDBBBBBBOXOO..OOOOOB
XDDBBBBBOXOOOOOOOOOB
XOOOOOOOOXOOOOOOOOOB
XBXXXXXXXXBBBBBBBBBB
220
_YA]QVW3
THE SILO
