XXXXXXXXXXXXXXXXXXXX
X.DOX.O..OX...OXXOOX
X.XOX.OX.OX....OO.OX
XS.O DOXDO D OXX..OX
XXXXXXXXXXXOOXXXD.OX
XOOOO.OO.O.XOOOO..OX
XO        OXXXX.DOOX
X. O O  O O.O.OX.XXX
B.OD           X   X
X. O       O O X O X
XO              X XX
XO O  O O O  O XX  X
XO             .  XO
XOOO.O.O.O.O.OOX   X
XXXXXXXXXXXXXXXXXDXO
105
XX\AY_U3
ONE WAY OR ANOTHER
