XXXXXXXXXXXXXXXXXXXX
X          O    XOOX
XOX.XXXOOOO   X XOOX
XOOOOOXOX.XOX.X.XOOX
XOXOXOXXOXOX..X.XOOX
XOXO.XOOXO.ODOD.XOOX
XOX.XOXXX.XXXOX.XOOX
XDX.X.OODS.OO.XDO.OB
X O..OXXX.XXXOX.XD.X
X.XOD..O.OXO....X..X
X.XOXXXXOXOX.OO.X.OX
X.OOOX.OX.XO.OXXOOXX
XDXXXOX ....XOO.OXXX
XXXXOOO.XX.OOO.OXXXX
XXXXXXXXXXXXXXXXXXXX
50
ZH\VSC]@
THE CROSSROADS
