XXXXXXXXXXXXXXXXXXXX
X0 O O O O O OOOOO X
X O O O O O O     OX
X         XXXXBOX OX
X         XOBO X O X
X          OOX XX OX
X         XXXO X O X
X     BOOXXXXO XX OX
X     O XOXX OOXO OX
X     XO OOO O    OX
X    XO   O O  X O X
X    XO       XO  OX
X    BO O O O  X O X
B      OXO O  DD SOX
XXXXXXXXXXXXXXXXXXXX
160
BB@JCDQ[
ANOTHER CRUCIAL START I'M AFRAID
