BBBBBBBBBBBBBOBBBBBB
B     O.O..BBBBBBBBB
B  BBBB.BO..BB BD..B
BB  BBBBBODBBB  BB.B
B   BD O OBB   BB..B
B B BSO   BB O B..BB
B B BBBBBBBBB BBB..B
B B BBBBBBB    BBB.B
B B      B    BB...B
B BB  B ODO    B.BBB
B B OO B B B B BD..B
B   O  B B B B BBB.B
BBOOD  O B   B.....B
BBO DD B BBBBBBBBBBB
BBBBBBBBBBBBBBBBBBBB
100
H_AXCBSC
A SORT OF MAZEY-TYPE THING.
