XSOXXXXXXXXXXXXXXXXX
X XO DX   X   XD   X
X XO  X X X X X  X X
XDXO  XOX   X    X X
XOXO OOOXXXXXXXXXXOX
XOOXXO           X X
X X  XO          X X
X OX  XO         X X
X XOXXO OO       X X
X OXDDXXXXOXXX   X X
X XO        OX   X X
X DX         X   X X
X XXXXXXXXXXXX   X X
X                X.X
XXXXXXXXXXXXXXXXXXOX
140
ALJJYEGC
AFTER THAT YOU NEED A REST
