XXXXXX       XXXXXXX
XOOOOX       X.....X
XO..OX       X.....X
XO..OX   D   X.....X
XO..OX OOOOO BO.O..X
XO..OX      XX.OBO.X
XO..OXXXXXXXXXOB.BOX
XO.DOOOOOOOOOOB...BX
XO...XXXXXXXXX...BOX
XO.O.X       B....OX
XO.O.X   O   B   O.X
XO...X   S   X..O..X
XO...B   D   X.O ..X
XOOO.B       XOD ..X
XXXXXX       OXXXXXX
100
XL\DQFZ\
JUST TAKE FIVE
