BOXB XBD X XBXXBX  X
X  BO X  X  XD BO .D
X  X DX OB O   X. .X
BXOBBXBXBBXBBXXBXBXO
X..XODX OXD X DX  XO
X .X  X OX  XO B  XO
B BB  BBXOXBOBXOXXOX
XODX..XO X  X  XOOXX
X. XO.X.OX O  OXOOXX
BOXB.XB. BOXBBXBXXBX
X DX DX.DX  X  XD BO
XSDX OX. XOD.  X  XX
BXXB XOBBBXBBXXBX BX
X00X O   X   O     D
XXXXXXXXOXXXXXXX..XX
125
OEKL[T@3
GRIDLOCK
