XXXXXXXXXXXXXXXXXXXX
X.....X...X......D.X
X..O..X.D.X...O....X
X.....X...X..XXXXBBX
XXXX..XBBXXOXB...D.X
X...BBXOB....B.O...X
X.S...OXB.BOXXXXXBBX
X..XXBXOB.XO.......X
X....BOXB.XO...D...X
X..D.BXOB.XO.......X
X....BOXB.XXBBXXXXXX
X...XOXXB.X..X.....B
X.O.B.....X........X
X...B.....X........X
XXXXXXXXXXXXXXXXXXXX
200
_YO]DT@@
THIS WAS THE FIRST LEVEL
