XXXXXXXXXXXXXXXXXXXX
X                XDX
X XXXX   XXXO   XO X
X O DX   XDB  O O  X
X XXXX  XXX XO O.X X
X  X    X   B O. X X
XXX          XXX.X X
X  X X XXX XXX . X X
X  X X X.X X.XOX.X X
X      X..O..X.X X X
X XX XXX.O O.X.X.X X
X XXXXOXO   OX . X X
X  O OXO  O  OX .X X
B O OXO XS DX OX   X
XXXXXXXXXXXXXXXXXXXX
120
NHBFUGWA
FIND YOUR WAY OUT OF THAT
