XXXXXXXXXXXBBXX0OOOX
B...B.B    O XXXXXXO
B..DBDBBXXO  X..OOOX
XXXXXX B  O  X O .SX
X..... XXXOD X.. XXX
X..... ..OXBBX.. ..X
X..... .ODXD.X.. ..X
X..... O..XBBX.. ..B
X.....O...XD.X.. ..B
X....O ...XBBXD. .OX
X...O. ...XD.X.. ODX
X..O.. ...XBBX..O..X
X.O... ...X..B.O ..X
XOD... ...X..BO. ..X
XXXXXXXXXXXBBXXXXXXO
220
CBFMUEFJ
LEAP BEFORE YOU LOOK
