XXXXXXXXXXXXXXXXXXX 
X........X........B 
X.S..D.O.X.X.X..O.B 
X..O...XXX.X.XXXXXX 
X.XXXXXO.X.X.X....X 
X.O    ..X.X.X.D..X 
XBXXXXXX X.X.X...OX 
X      X X.XOX..OBX 
X OX X XBX.....OBDX 
X    X XOX.D..OB..X 
X XX X XXX...OBD..X 
X      XXX..OBD...B 
X DXXX XXB.OB...O.B 
X         OBD.....B 
XXXXXXXXXXXXXXXXXXX 
280
_HLNCE[R
GO EAST YOUNG MAN
