XXXXXXXXXXXX        
X    O     X XXXXXX 
X X  X   XOX X D    
X  X XXXX  X XXXOOOD
X  X XDDX  X    XXOO
XO X X     XXXX   XO
X X  XOXXXXX   XX XO
X O XX  X   O  O  XO
X X DX  X XXXXX   XO
O  XXX  X   X XXXXXO
X  X ODXXXX X    O  
XO XO X   X X X   XX
X XXO  O  X X XXXXXD
XSXXOOOXX D X       
XXXXXXXXXXXXXXXXXXXX
101
_\[JQZK3
THE MOUSETRAP
