XXXXXXXXXXXXXXXXXXXX
X XO  OOOOOOOOOO   X
XXOXO XXXXXXXXX O  X
XOX X O    D  X  OXX
XXO X X  O OX X   OX
XOX X X  O OX X  OXX
XXO X X XOOOX X   OX
XOXXX X XXSXX X  OXX
OXX...X XOOOX X   OX
XOX.O.X ..... X  OXX
OXX..XXXX...XXX   OX
XOX.X . X...XXX    B
OXX.X. .XXXXXXXXXXXX
XOO...............DX
XXXXXXXXXXXXXXXXXXXX
120
\H@[QR^V
BREAK OUT
