XXXXXXXXXXXXXXXXXBBX
XOOO OOO OOO OOO  OX
XOXOXOXOXOXOXOXOX  X
XOXOXOXOXOXOXOXOXD X
XOXOXOXOXOXOXOXOX  X
XOXOXOXOXOXOXOXOX  X
XOXOXOXOXOXOXOXOXOOX
XOXOXOXOXOXOXOXOXOOX
XOXOXOXOXOXOXOXOXOOX
XOXOXOXOXOXOXOXOXOOX
X0XOXOXOXOXOXOXOXOOX
X XOXOXOXOXOXOXOXOOX
X XOXOXOXOXOXOXOXOOX
XSXOOOXOOOXOOOXOOOOX
XXXXXXXXXXXXXXXXXXXX
15
[H\[U123
GO AWAY
