XXXXXXXXXXXXXOOOXOXX
XXX   X   X OXXXOXOX
O   O.O O  DD O B.OX
X...  XD  X  O OO.BB
O XXXXOXBXXXXXXXX.XD
XX   OOODOOO OOO  OX
0XOOO   O   O   O OX
XSD O O O O O O O OX
0XO   O   O   O   OX
X  OOO OOO OOO OOO X
XBBBBBBBBBBBBBBBBBBX
XXXXXXXXXXXXXXXXXX.X
X.D................X
X.O.OOOOOOOOOOOOOOOX
DBXXXXXXXXXXXXXXXXXX
130
E_AAVXAG
RUN THE GAUNTLET
