XXXXXXXXXXXXXXXXXXXX
XS               DOX
XDXXXXXXXXXXXXXXXX X
X X.....XX D     X X
X X.X...X O  X XXX X
X X..XDX O...X X X X
X X...X O....X X X X
X X... O.....X X X X
X X.. O......X X X X
X X. OXXXXX..X XXX X
X X O.X...X..      X
X XO..X...X..   XXOX
X O...X...XXXXXXXX.X
XO............B    B
XXXXXXXXXXXXXXXXXXXX
120
^LJF_^TU
AS EASY AS IT LOOKS IF YOU THINK
