XXXXXXXXXXXXXXXXXXXX
XD XXX  D     D  DBB
X  OOOOOXOXOX X  O.X
X  XOOBOX X XXX  OBX
OOXXXXX OXX X.X  X X
X   X  .  OXO      X
X X.X X XO  X.XX.  X
XS.O. XOX   XX  XOXX
X X.XOX X    O  X  X
X   X  .OXOXOXX  X X
OOXOX X X X X    X X
X  XOXO X X XX XX  X
X  OO XXXOXOXX X X X
XD XXD             X
XXXXXXXXXXXXXXXXXXXX
110
XXCM\T@3
THE SAFE
