XXXXXXXXXXXXXXXXXXBB
XDOOOOXX.....OOOOXBB
X.XX.OXX.BB..X.OOXBB
X.XX.XXX0BB..X.OOXBB
XOXX.DXX.BB..X.OOXBB
XOXXD.XX.BB..X.OOXBB
XOXXOOXD.....X.OOXBB
X.XXOOX  ....X.OOXBB
XDXXOOX   ...X.OOXBB
X.XXOOXD  OOOX.OOXBB
X.XXO.XXOOOOOX.OOXBB
X.XX..XX....XXX..XBB
XSXX..XX....XXXX.XBB
XDXX...O....BBBBBBBB
XXXXXXXXXXXXBB....BB
60
HDIFDP^_
ANDRA'S FIRST
