XXXXXXXXXXXXXXXXX XX
X..  .. O    ..X. DX
X.OO .OOO   OO.XXBXX
X OOOOOOOOOOOO X. .X
X  OOO O OOO   X.O.X
X  OO O DOO  XOX. .X
X  OO OOODOO   XXDXX
XOOOO.O O OOOO X. .X
X OOO..  O OOO.X. .X
X O.OOOO OOOOO.XXBXX
X  OOOO O OO   X.O.X
XO  O OO  OO  XX. .X
XOO.O  O OOO  .XXDXX
XS    OO ...  ....OX
XXXXXXXXXXXXXXXXXXXX
75
^LXJTPDV
THE AIRLOCK
